0 0
00000000
00000000
00000000
00000000
00000000
00000000
00000000
00000000
0 1
00000000
0000L000
00000000
00000000
00000000
00000000
00000000
00000000
0 2
0000000T
00L00000
00000000
00000000
00000000
00000000
000000L0
00000000
0 4
T000000T
00000000
00000000
00000000
00000000
00000000
00000000
T000000T
0 5
00000000
00LLLLLL
0000000L
00000000
00000000
00000000
00000000
00000000
0 6
00000000
00000000
00000000
0000S000
00000000
00000000
00000000
00000000
1 0
0000000T
00000000
00000000
00000000
00000000
00000000
00000000
T000000T
1 3
00000000
00000000
00000000
000L0000
0000T000
00000000
00000000
00000000
1 4
00000000
00000000
00000000
00000L00
0L000000
000000L0
00000000
00000000
1 4
00000000
00000000
00000000
00000000
000LLL00
000LTL00
000LLL00
00000000
1 6
LLLLLLLL
LLLLLLLL
00000000
00000000
00000000
00000000
00000000
00000000
2 1
00000000
00000000
00000000
000TT000
000TT000
00000000
00000000
00000000
2 4
00000000
00000000
00000000
00000000
00000000
00000000
00000000
S000000S
2 6
00000000
00000000
00000000
L00LL0L0
LL0LL0LL
00000000
00000000
00000000
6 6
00000000
00000000
00000000
00000000
00000000
00000B00
00000000
00000000