0 0
00000000
00000000
00000000
00000000
00000000
00000000
00000000
00000000
0 1
00000000
0000L000
00000000
00000000
00000000
00000000
00000000
00000000
0 2
0000000T
00L00000
00000000
00000000
00000000
00000000
000000L0
00000000
0 4
T000000T
00000000
00000000
00000000
00000000
00000000
00000000
T000000T
0 5
00000000
00LLLLLL
0000000L
00000000
00000000
00000000
00000000
00000000
0 6
00000000
00000000
00000000
0000S000
00000000
00000000
00000000
00000000
1 0
0000000T
00000000
00000000
00000000
00000000
00000000
00000000
T000000T
1 3
00000000
00000000
00000000
000L0000
0000T000
00000000
00000000
00000000
1 4
00000000
00000000
00000000
00000L00
0L000000
000000L0
00000000
00000000
1 6
LLLLLLLL
LLLLLLLL
00000000
00000000
00000000
00000000
00000000
00000000
2 1
00000000
00000000
00000000
000TT000
000TT000
00000000
00000000
00000000
2 3
00000000
00000000
00000000
00000000
000LLL00
000LTL00
000LLL00
00000000
2 4
00000000
00000000
00000000
00000000
00000000
00000000
00000000
S000000S
2 6
00000000
00000000
00000000
L00LL0L0
LL0LL0LL
00000000
00000000
00000000
3 1
00000000
00000000
00000000
0L0TT0L0
00000000
00000000
00000000
00000000
3 5
00000000
00000000
00S00S00
00000000
00000000
00S00S00
00000000
00000000
4 0
0000000L
00000000
00000000
00000000
00000000
00000000
00000000
00000000
4 2
000000TT
0000000T
00000000
00000000
00000000
000LL000
00000000
0000000P
4 4
00000000
00000000
00000000
00000000
000PP000
000TL000
00000000
00000000
4 6
00000000
00T00000
00000000
0P00L000
000LTL00
00L00L00
00000000
00L00000
5 0
000000L0
00000000
00T00000
0000T000
00000000
00000000
000000P0
T0000000
5 3
000TT000
000000L0
00000000
00000000
00000000
0000L000
00000000
000TT000
5 4
LL0000LL
L000000L
00000000
00000000
000T0000
00000000
L000000L
LL0000LL
5 6
S000000S
00000000
00000000
000SS000
000SS000
00000000
00000000
S000000S
6 0
00000000
00000000
00000000
00000000
00000000
T0000000
TS000000
TTT00000
6 1
0000L00S
0000L000
000L0000
000L0000
0000T000
0000T000
00000000
00000000
6 5
LLLLLLLL
00000000
00000000
00000000
00000000
00000000
00000000
LLLLLLLL
6 6
00000000
00000000
00000000
00000000
00000000
00000B00
00000000
00000000