0,0
1110111
1011101
1110111
0100010
1110111
1010101
1110111