6 6
111?111
1?111?1
111?111
?1???1?
111?111
1?111?1
111?111